....................#.#............................#....#.#..#...#.#.....#................
........................#.#.#.....#..#...#.......#.........................#.#............
.........#...#.#....#.#.......#.............#........#.#....#...##.#....#......#..........
.......#.#.#......#.........#...........#.#....#.#........#.....#....#..........#.........
....#.........#.....#...##......#..#..#....#.#.....#...#......#....#....#.................
...........#.#..#....#......##..#..##...#......#.#.....##..#.......##......#.#....#.......
........#......##..#...#.#..##.....#...#.....#.....#.#....#...##.#.#.....#.....#....#.....
....#......#............#.#....#.#...#..#..#...#..........###....#....##....#.............
.........#...#.###..##.#...#...##.#....#.#....##..#...#.......#..#........#...#...#.......
....#.#......#......##..##...##..#.#.#..#..#..#...##....##..#.#..#.##..#....#.......#.....
.........#...##..#.#..#...#.......#.#......#..#.#.#........#..##.#.....##...#.....#.......
...#.#.#...#....#...#..#.#.#.#.#.#...#.###.#....#...###.#.#.#....#.#.#.....#..#......#....
.......#...##..#.#.#.##.#.....#.#..#..#....#.#.#..#.##...#...#.#..#...#.........#.#.......
.#...#...#....#...#.#..#.#.#.#.#.#...#...#.#....#...#.##..#.#.#....##...##..#..##...#.....
......#....#.#.#..##.####.#.#.#.#.#.#.###.#.#.#...#.....#..#.#.#.#...#..##...#....#.......
...#....##..#.#.#...#.##.#.#.#.#.#..#....#.#..#..#.#.#..#.#.#.#.#.#..#..#...#...#.....#...
.#.#.........#.#.#.####.#...#.#.#..#.#.#..#.#...#.#.#.#..#.#.#.#.#.#.##...#...#..#.#......
.....#..#.#.#.#.#.#..#..#.##.#.##.#...#.#..#...#.#....#.#.#.#.#.#.#.....#...#.........#...
..#.....##...#.#.#.#.#.#.#...###.#.#.#.#..#.#.#.#.###..#.#.#.#.#.#.#...#..##...#.#.#......
.....#.....##...#.#.#.#.#.#.#.#.#.#.#..###..##.#......#.#...#.#...#.#..##..#...#..........
...#.#...#....#.#..#.#.#.#.#.#.#.#.#..#.....#.#.#.##.#.#..#..#.#.#.#.#........#...#..##...
.......##.#..#.#.#.#.##.#.#.#...#.#.#...#.#..#........#.#...#.#.#.#.#..#.#....#...........
.#..........#.##..#.####.#.#.#.#.#.#.#...#.#....##.#.....#.#.#.#.#.#.#..#..##...#.#...#...
..#...#.#.#..#.###.#.#..#.#.#.#.#...###.#.#.#.#...#.#.#.#.#.#.#.#.#.#..#...##...#.........
......#..#.#..#..##..#...#...#...#.#.#.#.#.#.#.#.#.#.#.#.#.#.#.#.######.#..##..#...#.#....
...........#.#.#.##.#.#.#.#.#.#.#.#.#..#..#.#.#...#.#.#.#.#...#.###.##.#.#........#.......
..#.#.#.##.........#.#.#...#.#.#.....##.#..#.#.#.#.#.#.#.#.#...#.###..#.#.#..#.#.....#....
......#....##.###.#.#.#.#.#.#.#....#.#.#.#..#.#.#..##.#.#.#.#.#.#..#...#.#..##....##......
....#........#...#.#.#.#.#.#.#.#.##.#.#.#.#..#.#..#..#.#...#.#.#.#..#.#.#.#....#..........
..#.....###..##...##.##.#.#.#.#.#....#.########..#.#..#.#...#.#.#..#.#.#.#.#...#.....#.#..
......#.....#...#.#.#..#.#..##.#.#.##.#.###.#.#.#.#.##.#.#.#.#....#.#.#.#........##.......
...#....#..#..##.#.#..#.#.###.#.#.#....#.##..#.#.#.##.#..#..#.#.#.#..#.#.....#.#.....#....
.....#......##..#.#.##.#.#.#.#.#.#.#.#.#.####.#.#.##.#.##.#..#.#.#..#.#..###..#..#...#.#..
........#.#...#.#..#.#..#.#.#.#.#.#.#.#.#.#.#..#..#.#.#..#.#.#..#.#..#....#..#.....#......
...#.......#.#.#..#.#.##.#.#.#.#.#...#.#.#...#.#.#...#.##.#.#.##.#.#...#...#..#.#....#....
.....##...#...#.#..##.#.#.#.#...#..#..#..#..#.#.#..#..##.#.#.#..#.#.#.#..#...#....#.......
..#....#..##.#.#.##..#.#...#..#..#...#.##.####.#.#...#..#.#.#..#.#.#.#.#...#...##..#..#...
..#...#.....#.#...#.#.#.#.#.#...#.#.#.#..#..#.#.###.#.##.###.#..#.#...#....#...#...#......
....#..#..#..#.#.#.#.###.#.#.#.....#.#..#....#.#...###....###.##.#.#.#..##...#.......#....
.....#...#....#.#.#.#.###.#.#.#...#.#..#..##.#.#######.#.#.#.#..#.#.#..#..#..#...#........
.....#...#.#...#.#.#.#..##.#.#.#...#.##.#...#.#..#....#.#.#.#.#..#.#.....#.......#..#.....
...#.#......#.#...######..#...#.#.#.#..###.#.#.#..####..#..#.#..#.#.#..#.......#.#.#......
.......#...#..#.#.#####.#.#..#.#...###.#..#.#.#.#.###.##.##.#.#.#..#.#..#.#..#.#..........
.......#...#.#...#.#####.#.##.#.#.#...#.#..#.#.#.#..#.#.#..###.#..#.#.#..#....#..#...#....
.#.#....#..##.#.#.#.#####.#..#.#.#..##.#.#.##.#.#..#...#.####.#.#.#..#.#.##.#..........#..
.....#.#.#....#..#..#..#.#.#..#.#..#.##.#.#..#.#..#.#...#.#..#.#.#..#......#.#.#.#.#......
....#......#.#.#.#.#.##...#.#..#.##.#..#.#.#..#.##.#.#.#.#.##.#.#.##.##..#.........##.....
......#.#.#...#.#.#.#..#.#.#.##.#.#.###.#.#..#.##.###.#.#..#.#...##.#..#.......#...#..#...
#........#.#...#.#.#...#.#..#.#.##...#.#.#..#.#..##..#.#..#...#.#.#.#..#.#.###...#...#....
..#.......#.#.#.#.#.#.#.#.#..#.#..#.#.....#..#.####.#.#.##.#.#.#.#.#...#...#...........#..
#....#.#...#.#.#.#...#.#.#.##.##.#.#.#.#.#..#.#.##.#.#.#..#.#...#.##.#..##...#.#..#....#..
....#.....#.#.#.#.#.#.#.#....#.#..#.#.#.#..#.#.##.###.#.#..#.#.#.##.#...##...##......#....
.#....#.##.#...##..#.#.#.#.#.#.####.##.#.#..#.####.###.#.#.##.#.###..##....#....#....#...#
....#.#....#.#.#.#..##.##.#.#..#..###.#..#.#.#..#.#.#.#.#.#..#.##..###.#.#.##.#.#.........
........#...#.#.#.#.##.#.#.#.##.#.#..#.#..#.#..#.#.#.#...#..#.##..#.##....#.....##.#......
#...#.....#..#.#.#.#..#.#.#.##.#.#.###...#.#.#..#.#...#.#..#.#..##..#.#.#....##.....#.#...
..........##..#.#.#.##.#.#...##.#...#.#.#.#..#.#...#.#.#..#.#.####.#.#.#..#........#......
..#.#..#....#..#.#.#.##.#.#.#..#.#.#.#.#.#.#..#.#...#.#..#.#.#.######.#.#..#..##....#.#...
#..#..#..##...#.#.#.#..#.#.#..#.#.#.#.#.#..#.#.#.#.#.#.##...#.###.#.#..#..#.#.#...#.......
.....#...##.......#.#.#.#.#.#..#.#.#.##.....#.#.#.#.#..#...#####.###.#.##...#.#....#..#...
......#.....##.#.#.#.#.#.#.#..#.#.#.#..#.#.#.#.#.#.####.#.#..###..#.#.#...###...#.........
..#.....##..#...#.#.#.#.#.#..#.#.#.#.##.#.#.....#...#..#.#.#..###.#..##.#......#.....#.#..
....#...#...#..#.#.#.#.#.#.#.#..#.#.#..#.#.#...#.#.#.##...#.#..#.#.#.#.#..#....#..#.......
....#.....#...#.#.#.#.#.#.#.#..##.##..#.#.#.#...#.#.#.##.#.#.#.##.#####.#..#.#....#.#.#...
......##..##...#.#.#.#.#.#.#.##.#.#.##.#.#.#.#.#.#.#.#.##...#.#..#.#.#.#.#...#...#........
..........##.#..#.#.#.....#..#.###.#..#.#.#.#.#...#.#.#.#.#..#.#..#.#.#....#...#.#..#.#...
..#..#..#....#.#.#.#.#.#.#..#.#...#..#.#.#...#.#.#.#...#.#.#..#.#..#.#.......#............
.......#......#.#.#.#.#.#..#.#.###.#....#.#.#...#.#.#...#.#..#.#..#.#.#..#.#...#..#..#....
..........#..#.#.#.#......#...#.#.#.#.#..#.#.#...#.#.#...#..#......#.#.#....#..#..#.......
...#.#.......#.#....##.#.#.#.#.#.#.#..#.#...#.#.#...#.#.#.#..#..#.#...#..#.........#......
.......#...#.....##...##.............#.#...#.#.#..#..#......#..#...#.#.......#.#.#........
..#.#......#.#.#...#.#...##.#.#..####.#....##.......#.##...#.#...#...#.#.##...##.....#....
.......#.#..#.#.#.#.#.#.#.....#..#.....#.#...##.#.#.....##....#.#.#..#...#..#......#......
.....#.....#..#..#.#...#...#.#.#...#.#.#...#......##.#..#..##....#..#..#..#......#...#....
.......#....#.#.##.......#.....#.#..#.#....#..##....##.......###...#....#...#.##...#......
...#.#..#......#.....#.#.#..#.##...#....##...#.........#..#..#...................#........
...#......#.#.....##.....##.......#.....#.......###..#....#......#.#..#..#.#.#......#.....
.............#...#..#..#........#...##......#...#....#..#..#.#.#...#..#...........#.......
.....#..#.#....#.......#.#.#.#....#......#.#.#...#...#.#.........#.#...#...#.#......#.....
.............#..#..#.....#.#.#.#......#..#.##...#........#.#.#......#..#...#..#.#.........
.......#.#........#..#....#....#...#.#...........#..#..##...#..#..#......#..#...#..#......
............#.#...#...#.....#..#.......#.#.#.#......#.#....#..#..#...#.#...#..............
................#.....##....#....#........#...#..................##........#.....#........
..........#...#..#........#........#.#.#....#...#.#.#...##..#.......#..#.....#............
...................#..#.#....#.#.#................#.......#...#..#........#....#..........
................#...........#.......#...#....#....#..................#.#....#.............
..................#.....#.....#..#...............................#.#......................
